TEMPLATES


Don't see a template you like? Let me know: mertis01@luther.edu


Template Name : Type of Page/Template


======


AdminLTE : Admin Panel


Alpha : Full site.


Andia : Agency/Portfolio


Design Template : Full Site


Escape Velocity : One Page


eShopper : eCommerce 


Fashion Blog : Full Blog Site


Grayscale : One Page


Gumba : News/Blog Article 


La Casa : Real Estate 


Landing Page : Landing One Page


Magnetic : Photography 


Mamba : One Page


Mobile Cloud : App One Page


Moderna : Business 


Overflow : One Page


Pinball Pack : Corporate Template Pack


Prologue : Panel Website


SB Admin : Admin Panel


SB Admin 2 : Admin Panel


Shop Homepage : eCommerce

Spectral : Full site


Sporthere : Sports Business


Squad Free : One Page Start-Up


Strongly Typed : Minimal, Semi-Retro


Sublime : Creative Agencies and Portfolio


Twenty : One Page Parallax


======
